========================================
=..............................=========
=....@.........................=========
=..............................=========
=+..=......................=..+=========
=====......................=============
=..............................=========
=.......====........====.......=========
=..............................=========
=..............................=========
=+..=.........====.........=..+=.......=
=====......................=====.......=
=.........N.....................=......=
=.......====........====.......0.......=
=.............................000......=
=............................00000.....=
===================================000==
================================.......=
================================.......=
================================...==..=
================================.......=
================================.......=
=....................................===
=....................................===
========================================