#...............#
#...............#
#........####...#
#...............#
#...............#
#.###...........#
#...............#
#...............#
#........###....#
#...............#
#.@.............#
#############...#