=...............=
=..........#....=
=........====...=
=...............=
=..#............=
=.===...........=
=...............=
=........#......=
=.=......===....=
=...............=
=.@......=.#....=
=============...=