=...............=
=..........#....=
=........====...=
=...............=
=..#............=
=.===...........=
=...............=
=........#......=
=.=......===..#.=
=...............=
=.@......=......=
=============...=