=================================================================================
=...............................................................................=
=...@...........................................................................=
=...............................................................................=
=...............................................................................=
=+..............................................................................=
=========================================================================.....===
=..&&&&&........................................................................=
=...............................................................................=
=............======.......................=====.................................=
=........................................00000=............0....................=
=..............#.......=.#...=..........000000=......#.....=....................=
===00000=========================================================================
=.....................&.....&......&............................................=
=...............................................#...#...........................=
=..............................................=======................0=........=
=....................................................................00=........=
=.............=.......#.........#.....=.....#.......#...............000=...N....=
=================================================================================