=...............=
=...............=
=........====...=
=...............=
=...............=
=.===...........=
=...............=
=........#......=
=.=......===....=
=...............=
=.@......=......=
=============...=