===============================================
=.............................................=
=.............................................=
=......................=.....#....=...........=
=........===.....==========================...=
=................=......&......&......&.......=
=.===............=............................=
=................=............................=
=.=......===.....=............................=
=........0....................................=
=.@......=.#.................................+=
=============...===============================