=============...===============================
=.............................................=
=.............................................=
=......................=.....#....=...........=
=........===.....==========================...=
=.......................&......&......&.......=
=.===.........................................=
=................=............................=
=.=......===.....=......0.....................=
=........0....................................=
=.@......=.#.................................+=
=============...===============================