=................=
=..........#.....=
=........====....=
=................=
=..#.............=
=.===............=
=................=
=........#.......=
=.=......===.......0
=........0........00
=.@......=.#.....000...+=
=============...=========